#######
#-----#
#@$$.-#
#--.--#
#######
