#######
##   ##
#  $  #
# $   #
#@$$  #
##....#
#######
