#######
#     #
#@$$. #
#  .  #
#######
