#######
#     #
#     #
#@$$. #
## .  #
#######
