######
#    #
#    #
#@$#.#
#    #
######
