########
#.#.#.##
#      #
#   #  #
# $$$  #
#     @#
########
